2 1 1 1 1 1 1 1 1 1 2 1 1 1 1 1 1 1 2
2 4 4 4 4 4 4 4 4 4 2 4 4 4 4 4 4 4 2
2 4 4 4 4 4 5 4 4 4 2 4 4 4 4 4 4 4 2
2 4 4 4 4 4 4 2 4 4 2 4 4 4 4 4 4 4 2
2 4 4 4 4 4 4 2 4 4 2 4 4 4 4 4 4 4 2
2 4 4 4 4 4 4 2 4 4 2 4 4 4 4 4 4 4 2
2 4 4 4 4 4 4 2 4 4 2 4 4 4 4 4 4 4 2
2 4 4 4 4 4 4 2 4 4 2 4 4 4 4 4 4 4 2
2 4 4 4 4 4 4 2 4 4 2 3 4 3 4 3 4 3 2
2 4 4 4 4 4 4 2 4 4 2 1 1 1 1 1 1 1 2
2 1 1 1 1 1 1 1 4 4 4 4 4 4 4 5 4 5 2
2 5 4 4 4 4 4 4 4 4 4 4 4 4 4 4 4 4 2
2 3 4 4 4 4 4 4 4 4 4 4 4 4 4 4 4 4 2
2 5 4 4 4 4 4 4 4 4 4 4 4 4 4 4 4 6 2
1 1 1 1 1 1 1 1 1 1 1 1 1 1 1 1 1 1 1