2 1 1 1 1 1 2 1 1 1 1 1 1 1 1 1 1 1 2
2 4 4 4 5 4 2 4 4 4 4 4 4 4 4 4 4 4 2
2 4 4 4 4 4 2 4 4 4 4 4 4 4 4 4 4 4 2
2 4 4 4 4 4 2 4 4 4 2 4 4 4 4 4 4 4 2
2 4 4 4 4 4 2 4 4 4 2 4 4 4 4 4 4 4 2
2 4 4 4 4 4 2 4 4 4 2 4 4 4 4 4 4 4 2
2 4 4 4 4 4 2 4 4 4 2 4 4 4 4 4 4 4 2
2 4 4 4 4 4 2 4 4 4 2 4 4 4 4 4 4 5 2
2 4 4 4 4 4 2 4 4 4 2 4 4 4 4 4 5 6 2
2 4 4 4 4 4 2 4 4 4 2 1 1 1 1 1 1 1 2
2 4 4 1 1 1 1 1 4 1 1 4 4 4 4 4 4 5 2
2 4 4 4 4 4 4 4 4 4 4 4 4 4 4 4 4 3 2
2 4 4 4 4 4 4 4 4 4 4 4 4 4 4 4 4 4 2
2 4 4 4 4 4 4 4 4 4 4 4 4 4 4 4 4 5 2
1 1 1 1 1 1 1 1 1 1 1 1 1 1 1 1 1 1 1