2 1 1 1 1 1 2 1 1 2 1 1 1 1 1 2 1 1 2
2 4 4 4 5 4 4 4 5 2 5 4 3 4 5 2 4 6 2
2 4 4 4 4 4 4 4 4 2 4 4 4 4 4 2 4 4 2
2 4 4 2 4 4 2 4 4 2 4 4 2 4 4 2 4 4 2
2 4 4 2 4 4 2 4 4 2 4 4 2 4 4 2 4 4 2
2 4 4 2 4 4 2 4 4 2 4 4 2 4 4 2 4 4 2
2 4 4 2 4 4 2 4 4 2 4 4 2 4 4 2 4 4 2
2 4 4 2 4 4 2 4 4 2 4 4 2 4 4 2 4 4 2
2 4 4 2 4 4 2 4 4 2 4 4 2 4 4 2 4 4 2
2 4 4 2 4 4 2 4 4 2 4 4 2 4 4 2 4 4 2
2 4 4 2 4 4 2 1 4 2 4 4 2 4 4 2 4 4 2
2 4 4 1 4 4 2 4 4 1 4 4 1 4 4 1 4 4 2
2 4 4 4 4 4 2 4 4 4 4 4 4 4 4 4 4 4 2
2 5 4 3 4 5 2 5 4 4 4 5 4 5 4 4 4 5 2
1 1 1 1 1 1 1 1 1 1 1 1 1 1 1 1 1 1 1